City of London	City of London	London
Abbey	Barking and Dagenham	London
Alibon	Barking and Dagenham	London
Becontree	Barking and Dagenham	London
Chadwell Heath	Barking and Dagenham	London
Eastbrook	Barking and Dagenham	London
Eastbury	Barking and Dagenham	London
Gascoigne	Barking and Dagenham	London
Goresbrook	Barking and Dagenham	London
Heath	Barking and Dagenham	London
Longbridge	Barking and Dagenham	London
Mayesbrook	Barking and Dagenham	London
Parsloes	Barking and Dagenham	London
River	Barking and Dagenham	London
Thames	Barking and Dagenham	London
Valence	Barking and Dagenham	London
Village	Barking and Dagenham	London
Whalebone	Barking and Dagenham	London
Brunswick Park	Barnet	London
Burnt Oak	Barnet	London
Childs Hill	Barnet	London
Colindale	Barnet	London
Coppetts	Barnet	London
East Barnet	Barnet	London
East Finchley	Barnet	London
Edgware	Barnet	London
Finchley Church End	Barnet	London
Garden Suburb	Barnet	London
Golders Green	Barnet	London
Hale	Barnet	London
Hendon	Barnet	London
High Barnet	Barnet	London
Mill Hill	Barnet	London
Oakleigh	Barnet	London
Totteridge	Barnet	London
Underhill	Barnet	London
West Finchley	Barnet	London
West Hendon	Barnet	London
Woodhouse	Barnet	London
Barnehurst	Bexley	London
Belvedere	Bexley	London
Blackfen and Lamorbey	Bexley	London
Blendon and Penhill	Bexley	London
Brampton	Bexley	London
Christchurch	Bexley	London
Colyers	Bexley	London
Crayford	Bexley	London
Cray Meadows	Bexley	London
Danson Park	Bexley	London
East Wickham	Bexley	London
Erith	Bexley	London
Falconwood and Welling	Bexley	London
Lesnes Abbey	Bexley	London
Longlands	Bexley	London
North End	Bexley	London
Northumberland Heath	Bexley	London
St. Mary's	Bexley	London
St. Michael's	Bexley	London
Sidcup	Bexley	London
Thamesmead East	Bexley	London
Alperton	Brent	London
Barnhill	Brent	London
Brondesbury Park	Brent	London
Dollis Hill	Brent	London
Dudden Hill	Brent	London
Fryent	Brent	London
Harlesden	Brent	London
Kensal Green	Brent	London
Kenton	Brent	London
Kilburn	Brent	London
Mapesbury	Brent	London
Northwick Park	Brent	London
Preston	Brent	London
Queens Park	Brent	London
Queensbury	Brent	London
Stonebridge	Brent	London
Sudbury	Brent	London
Tokyngton	Brent	London
Welsh Harp	Brent	London
Wembley Central	Brent	London
Willesden Green	Brent	London
Bickley	Bromley	London
Biggin Hill	Bromley	London
Bromley Common and Keston	Bromley	London
Bromley Town	Bromley	London
Chelsfield and Pratts Bottom	Bromley	London
Chislehurst	Bromley	London
Clock House	Bromley	London
Copers Cope	Bromley	London
Cray Valley East	Bromley	London
Cray Valley West	Bromley	London
Crystal Palace	Bromley	London
Darwin	Bromley	London
Farnborough and Crofton	Bromley	London
Hayes and Coney Hall	Bromley	London
Kelsey and Eden Park	Bromley	London
Mottingham and Chislehurst North	Bromley	London
Orpington	Bromley	London
Penge and Cator	Bromley	London
Petts Wood and Knoll	Bromley	London
Plaistow and Sundridge	Bromley	London
Shortlands	Bromley	London
West Wickham	Bromley	London
Belsize	Camden	London
Bloomsbury	Camden	London
Camden Town with Primrose Hill	Camden	London
Cantelowes	Camden	London
Fortune Green	Camden	London
Frognal and Fitzjohns	Camden	London
Gospel Oak	Camden	London
Hampstead Town	Camden	London
Haverstock	Camden	London
Highgate	Camden	London
Holborn and Covent Garden	Camden	London
Kentish Town	Camden	London
Kilburn	Camden	London
King's Cross	Camden	London
Regent's Park	Camden	London
St. Pancras and Somers Town	Camden	London
Swiss Cottage	Camden	London
West Hampstead	Camden	London
Addiscombe	Croydon	London
Ashburton	Croydon	London
Bensham Manor	Croydon	London
Broad Green	Croydon	London
Coulsdon East	Croydon	London
Coulsdon West	Croydon	London
Croham	Croydon	London
Fairfield	Croydon	London
Fieldway	Croydon	London
Heathfield	Croydon	London
Kenley	Croydon	London
New Addington	Croydon	London
Norbury	Croydon	London
Purley	Croydon	London
Sanderstead	Croydon	London
Selhurst	Croydon	London
Selsdon and Ballards	Croydon	London
Shirley	Croydon	London
South Norwood	Croydon	London
Thornton Heath	Croydon	London
Upper Norwood	Croydon	London
Waddon	Croydon	London
West Thornton	Croydon	London
Woodside	Croydon	London
Acton Central	Ealing	London
Cleveland	Ealing	London
Dormers Wells	Ealing	London
Ealing Broadway	Ealing	London
Ealing Common	Ealing	London
East Acton	Ealing	London
Elthorne	Ealing	London
Greenford Broadway	Ealing	London
Greenford Green	Ealing	London
Hanger Hill	Ealing	London
Hobbayne	Ealing	London
Lady Margaret	Ealing	London
Northfield	Ealing	London
North Greenford	Ealing	London
Northolt Mandeville	Ealing	London
Northolt West End	Ealing	London
Norwood Green	Ealing	London
Perivale	Ealing	London
South Acton	Ealing	London
Southall Broadway	Ealing	London
Southall Green	Ealing	London
Southfield	Ealing	London
Walpole	Ealing	London
Bowes	Enfield	London
Bush Hill Park	Enfield	London
Chase	Enfield	London
Cockfosters	Enfield	London
Edmonton Green	Enfield	London
Enfield Highway	Enfield	London
Enfield Lock	Enfield	London
Grange	Enfield	London
Haselbury	Enfield	London
Highlands	Enfield	London
Jubilee	Enfield	London
Lower Edmonton	Enfield	London
Palmers Green	Enfield	London
Ponders End	Enfield	London
Southbury	Enfield	London
Southgate	Enfield	London
Southgate Green	Enfield	London
Town	Enfield	London
Turkey Street	Enfield	London
Upper Edmonton	Enfield	London
Winchmore Hill	Enfield	London
Abbey Wood	Greenwich	London
Blackheath Westcombe	Greenwich	London
Charlton	Greenwich	London
Coldharbour and New Eltham	Greenwich	London
Eltham North	Greenwich	London
Eltham South	Greenwich	London
Eltham West	Greenwich	London
Glyndon	Greenwich	London
Greenwich West	Greenwich	London
Kidbrooke with Hornfair	Greenwich	London
Middle Park and Sutcliffe	Greenwich	London
Peninsula	Greenwich	London
Plumstead	Greenwich	London
Shooters Hill	Greenwich	London
Thamesmead Moorings	Greenwich	London
Woolwich Common	Greenwich	London
Woolwich Riverside	Greenwich	London
Brownswood	Hackney	London
Cazenove	Hackney	London
Chatham	Hackney	London
Clissold	Hackney	London
Dalston	Hackney	London
De Beauvoir	Hackney	London
Hackney Central	Hackney	London
Hackney Downs	Hackney	London
Haggerston	Hackney	London
Hoxton	Hackney	London
King's Park	Hackney	London
Leabridge	Hackney	London
Lordship	Hackney	London
New River	Hackney	London
Queensbridge	Hackney	London
Springfield	Hackney	London
Stoke Newington Central	Hackney	London
Victoria	Hackney	London
Wick	Hackney	London
Addison	Hammersmith and Fulham	London
Askew	Hammersmith and Fulham	London
Avonmore and Brook Green	Hammersmith and Fulham	London
College Park and Old Oak	Hammersmith and Fulham	London
Fulham Broadway	Hammersmith and Fulham	London
Fulham Reach	Hammersmith and Fulham	London
Hammersmith Broadway	Hammersmith and Fulham	London
Munster	Hammersmith and Fulham	London
North End	Hammersmith and Fulham	London
Palace Riverside	Hammersmith and Fulham	London
Parsons Green and Walham	Hammersmith and Fulham	London
Ravenscourt Park	Hammersmith and Fulham	London
Sands End	Hammersmith and Fulham	London
Shepherd's Bush Green	Hammersmith and Fulham	London
Town	Hammersmith and Fulham	London
Wormholt and White City	Hammersmith and Fulham	London
Alexandra	Haringey	London
Bounds Green	Haringey	London
Bruce Grove	Haringey	London
Crouch End	Haringey	London
Fortis Green	Haringey	London
Harringay	Haringey	London
Highgate	Haringey	London
Hornsey	Haringey	London
Muswell Hill	Haringey	London
Noel Park	Haringey	London
Northumberland Park	Haringey	London
St. Ann's	Haringey	London
Seven Sisters	Haringey	London
Stroud Green	Haringey	London
Tottenham Green	Haringey	London
Tottenham Hale	Haringey	London
West Green	Haringey	London
White Hart Lane	Haringey	London
Woodside	Haringey	London
Belmont	Harrow	London
Canons	Harrow	London
Edgware	Harrow	London
Greenhill	Harrow	London
Harrow on the Hill	Harrow	London
Harrow Weald	Harrow	London
Hatch End	Harrow	London
Headstone North	Harrow	London
Headstone South	Harrow	London
Kenton East	Harrow	London
Kenton West	Harrow	London
Marlborough	Harrow	London
Pinner	Harrow	London
Pinner South	Harrow	London
Queensbury	Harrow	London
Rayners Lane	Harrow	London
Roxbourne	Harrow	London
Roxeth	Harrow	London
Stanmore Park	Harrow	London
Wealdstone	Harrow	London
West Harrow	Harrow	London
Brooklands	Havering	London
Cranham	Havering	London
Elm Park	Havering	London
Emerson Park	Havering	London
Gooshays	Havering	London
Hacton	Havering	London
Harold Wood	Havering	London
Havering Park	Havering	London
Heaton	Havering	London
Hylands	Havering	London
Mawneys	Havering	London
Pettits	Havering	London
Rainham and Wennington	Havering	London
Romford Town	Havering	London
St. Andrew's	Havering	London
South Hornchurch	Havering	London
Squirrel's Heath	Havering	London
Upminster	Havering	London
Barnhill	Hillingdon	London
Botwell	Hillingdon	London
Brunel	Hillingdon	London
Cavendish	Hillingdon	London
Charville	Hillingdon	London
Eastcote and East Ruislip	Hillingdon	London
Harefield	Hillingdon	London
Heathrow Villages	Hillingdon	London
Hillingdon East	Hillingdon	London
Ickenham	Hillingdon	London
Manor	Hillingdon	London
Northwood	Hillingdon	London
Northwood Hills	Hillingdon	London
Pinkwell	Hillingdon	London
South Ruislip	Hillingdon	London
Townfield	Hillingdon	London
Uxbridge North	Hillingdon	London
Uxbridge South	Hillingdon	London
West Drayton	Hillingdon	London
West Ruislip	Hillingdon	London
Yeading	Hillingdon	London
Yiewsley	Hillingdon	London
Bedfont	Hounslow	London
Brentford	Hounslow	London
Chiswick Homefields	Hounslow	London
Chiswick Riverside	Hounslow	London
Cranford	Hounslow	London
Feltham North	Hounslow	London
Feltham West	Hounslow	London
Hanworth	Hounslow	London
Hanworth Park	Hounslow	London
Heston Central	Hounslow	London
Heston East	Hounslow	London
Heston West	Hounslow	London
Hounslow Central	Hounslow	London
Hounslow Heath	Hounslow	London
Hounslow South	Hounslow	London
Hounslow West	Hounslow	London
Isleworth	Hounslow	London
Osterley and Spring Grove	Hounslow	London
Syon	Hounslow	London
Turnham Green	Hounslow	London
Barnsbury	Islington	London
Bunhill	Islington	London
Caledonian	Islington	London
Canonbury	Islington	London
Clerkenwell	Islington	London
Finsbury Park	Islington	London
Highbury East	Islington	London
Highbury West	Islington	London
Hillrise	Islington	London
Holloway	Islington	London
Junction	Islington	London
Mildmay	Islington	London
St. George's	Islington	London
St. Mary's	Islington	London
St. Peter's	Islington	London
Tollington	Islington	London
Abingdon	Kensington and Chelsea	London
Brompton	Kensington and Chelsea	London
Campden	Kensington and Chelsea	London
Colville	Kensington and Chelsea	London
Courtfield	Kensington and Chelsea	London
Cremorne	Kensington and Chelsea	London
Earl's Court	Kensington and Chelsea	London
Golborne	Kensington and Chelsea	London
Hans Town	Kensington and Chelsea	London
Holland	Kensington and Chelsea	London
Norland	Kensington and Chelsea	London
Notting Barns	Kensington and Chelsea	London
Pembridge	Kensington and Chelsea	London
Queen's Gate	Kensington and Chelsea	London
Redcliffe	Kensington and Chelsea	London
Royal Hospital	Kensington and Chelsea	London
St. Charles	Kensington and Chelsea	London
Stanley	Kensington and Chelsea	London
Alexandra	Kingston upon Thames	London
Berrylands	Kingston upon Thames	London
Beverley	Kingston upon Thames	London
Canbury	Kingston upon Thames	London
Chessington North and Hook	Kingston upon Thames	London
Chessington South	Kingston upon Thames	London
Coombe Hill	Kingston upon Thames	London
Coombe Vale	Kingston upon Thames	London
Grove	Kingston upon Thames	London
Norbiton	Kingston upon Thames	London
Old Malden	Kingston upon Thames	London
St. James	Kingston upon Thames	London
St. Mark's	Kingston upon Thames	London
Surbiton Hill	Kingston upon Thames	London
Tolworth and Hook Rise	Kingston upon Thames	London
Tudor	Kingston upon Thames	London
Bishop's	Lambeth	London
Brixton Hill	Lambeth	London
Clapham Common	Lambeth	London
Clapham Town	Lambeth	London
Coldharbour	Lambeth	London
Ferndale	Lambeth	London
Gipsy Hill	Lambeth	London
Herne Hill	Lambeth	London
Knight's Hill	Lambeth	London
Larkhall	Lambeth	London
Oval	Lambeth	London
Prince's	Lambeth	London
St. Leonard's	Lambeth	London
Stockwell	Lambeth	London
Streatham Hill	Lambeth	London
Streatham South	Lambeth	London
Streatham Wells	Lambeth	London
Thornton	Lambeth	London
Thurlow Park	Lambeth	London
Tulse Hill	Lambeth	London
Vassall	Lambeth	London
Bellingham	Lewisham	London
Blackheath	Lewisham	London
Brockley	Lewisham	London
Catford South	Lewisham	London
Crofton Park	Lewisham	London
Downham	Lewisham	London
Evelyn	Lewisham	London
Forest Hill	Lewisham	London
Grove Park	Lewisham	London
Ladywell	Lewisham	London
Lee Green	Lewisham	London
Lewisham Central	Lewisham	London
New Cross	Lewisham	London
Perry Vale	Lewisham	London
Rushey Green	Lewisham	London
Sydenham	Lewisham	London
Telegraph Hill	Lewisham	London
Whitefoot	Lewisham	London
Abbey	Merton	London
Cannon Hill	Merton	London
Colliers Wood	Merton	London
Cricket Green	Merton	London
Dundonald	Merton	London
Figge's Marsh	Merton	London
Graveney	Merton	London
Hillside	Merton	London
Lavender Fields	Merton	London
Longthornton	Merton	London
Lower Morden	Merton	London
Merton Park	Merton	London
Pollards Hill	Merton	London
Ravensbury	Merton	London
Raynes Park	Merton	London
St. Helier	Merton	London
Trinity	Merton	London
Village	Merton	London
West Barnes	Merton	London
Wimbledon Park	Merton	London
Beckton	Newham	London
Boleyn	Newham	London
Canning Town North	Newham	London
Canning Town South	Newham	London
Custom House	Newham	London
East Ham Central	Newham	London
East Ham North	Newham	London
East Ham South	Newham	London
Forest Gate North	Newham	London
Forest Gate South	Newham	London
Green Street East	Newham	London
Green Street West	Newham	London
Little Ilford	Newham	London
Manor Park	Newham	London
Plaistow North	Newham	London
Plaistow South	Newham	London
Royal Docks	Newham	London
Stratford and New Town	Newham	London
Wall End	Newham	London
West Ham	Newham	London
Aldborough	Redbridge	London
Barkingside	Redbridge	London
Bridge	Redbridge	London
Chadwell	Redbridge	London
Church End	Redbridge	London
Clayhall	Redbridge	London
Clementswood	Redbridge	London
Cranbrook	Redbridge	London
Fairlop	Redbridge	London
Fullwell	Redbridge	London
Goodmayes	Redbridge	London
Hainault	Redbridge	London
Loxford	Redbridge	London
Mayfield	Redbridge	London
Monkhams	Redbridge	London
Newbury	Redbridge	London
Roding	Redbridge	London
Seven Kings	Redbridge	London
Snaresbrook	Redbridge	London
Valentines	Redbridge	London
Wanstead	Redbridge	London
Barnes	Richmond upon Thames	London
East Sheen	Richmond upon Thames	London
Fulwell and Hampton Hill	Richmond upon Thames	London
Ham
Hampton	Richmond upon Thames	London
Hampton North	Richmond upon Thames	London
Hampton Wick	Richmond upon Thames	London
Heathfield	Richmond upon Thames	London
Kew	Richmond upon Thames	London
Mortlake and Barnes Common	Richmond upon Thames	London
North Richmond	Richmond upon Thames	London
St. Margarets & North Twickenham	Richmond upon Thames	London
South Richmond	Richmond upon Thames	London
South Twickenham	Richmond upon Thames	London
Teddington	Richmond upon Thames	London
Twickenham Riverside	Richmond upon Thames	London
West Twickenham	Richmond upon Thames	London
Whitton	Richmond upon Thames	London
Brunswick Park	Southwark	London
Camberwell Green	Southwark	London
Cathedrals	Southwark	London
Chaucer	Southwark	London
College	Southwark	London
East Dulwich	Southwark	London
East Walworth	Southwark	London
Faraday	Southwark	London
Grange	Southwark	London
Livesey	Southwark	London
Newington	Southwark	London
Nunhead	Southwark	London
Peckham	Southwark	London
Peckham Rye	Southwark	London
Riverside	Southwark	London
Rotherhithe	Southwark	London
South Bermondsey	Southwark	London
South Camberwell	Southwark	London
Surrey Docks	Southwark	London
The Lane	Southwark	London
Village	Southwark	London
Beddington North	Sutton	London
Beddington South	Sutton	London
Belmont	Sutton	London
Carshalton Central	Sutton	London
Carshalton South and Clockhouse	Sutton	London
Cheam	Sutton	London
Nonsuch	Sutton	London
St. Helier	Sutton	London
Stonecot	Sutton	London
Sutton Central	Sutton	London
Sutton North	Sutton	London
Sutton South	Sutton	London
Sutton West	Sutton	London
The Wrythe	Sutton	London
Wallington North	Sutton	London
Wallington South	Sutton	London
Wandle Valley	Sutton	London
Worcester Park	Sutton	London
Bethnal Green North	Tower Hamlets	London
Bethnal Green South	Tower Hamlets	London
Blackwall and Cubitt Town	Tower Hamlets	London
Bow East	Tower Hamlets	London
Bow West	Tower Hamlets	London
Bromley-by-Bow	Tower Hamlets	London
East India and Lansbury	Tower Hamlets	London
Limehouse	Tower Hamlets	London
Mile End and Globe Town	Tower Hamlets	London
Mile End East	Tower Hamlets	London
Millwall	Tower Hamlets	London
St. Dunstan's and Stepney Green	Tower Hamlets	London
St. Katherine's and Wapping	Tower Hamlets	London
Shadwell	Tower Hamlets	London
Spitalfields and Banglatown	Tower Hamlets	London
Weavers	Tower Hamlets	London
Whitechapel	Tower Hamlets	London
Cann Hall	Waltham Forest	London
Cathall	Waltham Forest	London
Chapel End	Waltham Forest	London
Chingford Green	Waltham Forest	London
Endlebury	Waltham Forest	London
Forest	Waltham Forest	London
Grove Green	Waltham Forest	London
Hale End and Highams Park	Waltham Forest	London
Hatch Lane	Waltham Forest	London
High Street	Waltham Forest	London
Higham Hill	Waltham Forest	London
Hoe Street	Waltham Forest	London
Larkswood	Waltham Forest	London
Lea Bridge	Waltham Forest	London
Leyton	Waltham Forest	London
Leytonstone	Waltham Forest	London
Markhouse	Waltham Forest	London
Valley	Waltham Forest	London
William Morris	Waltham Forest	London
Wood Street	Waltham Forest	London
Balham	Wandsworth	London
Bedford	Wandsworth	London
Earlsfield	Wandsworth	London
East Putney	Wandsworth	London
Fairfield	Wandsworth	London
Furzedown	Wandsworth	London
Graveney	Wandsworth	London
Latchmere	Wandsworth	London
Nightingale	Wandsworth	London
Northcote	Wandsworth	London
Queenstown	Wandsworth	London
Roehampton	Wandsworth	London
St. Mary's Park	Wandsworth	London
Shaftesbury	Wandsworth	London
Southfields	Wandsworth	London
Thamesfield	Wandsworth	London
Tooting	Wandsworth	London
Wandsworth Common	Wandsworth	London
West Hill	Wandsworth	London
West Putney	Wandsworth	London
Abbey Road	Westminster	London
Bayswater	Westminster	London
Bryanston and Dorset Square	Westminster	London
Churchill	Westminster	London
Church Street	Westminster	London
Harrow Road	Westminster	London
Hyde Park	Westminster	London
Knightsbridge and Belgravia	Westminster	London
Lancaster Gate	Westminster	London
Little Venice	Westminster	London
Maida Vale	Westminster	London
Marylebone High Street	Westminster	London
Queen's Park	Westminster	London
Regent's Park	Westminster	London
St. James's	Westminster	London
Tachbrook	Westminster	London
Vincent Square	Westminster	London
Warwick	Westminster	London
Westbourne	Westminster	London
West End	Westminster	London